AIRA comment = "a detector made in air  ", sys = "phmd", module = "phmdgeo.g"
ALMF comment = "an Aluminum sheet", sys = "rich", module = "richgeo.g"
ALUM comment = "an Aluminum sheet", sys = "rich", module = "richgeo.g"
ASTR comment = "the  strip", sys = "phmd", module = "phmdgeo.g"
BANG comment = "an angled part of TPC cooling structure ( Aile )", sys = "btof", module = "btofgeo1:6.g"
BARM comment = "a TPC cooling structure arm             ( Material  Aluminium )", sys = "btof", module = "btofgeo1.g"
BARM comment = "a TPC cooling structure arm             ( Material  Aluminium )", sys = "btof", module = "btofgeo2.g"
BARM comment = "a TPC cooling structure arm             ( Material  Aluminium )", sys = "btof", module = "btofgeo3.g"
BARM comment = "a TPC cooling structure arm             ( Material  Aluminium )", sys = "btof", module = "btofgeo4.g"
BARM comment = "a TPC cooling structure arm             ( Material  Aluminium )", sys = "btof", module = "btofgeo5|6.g"
BARR comment = "e Barrette quarzo opaco", sys = "rich", module = "richgeo.g"
BASA comment = "the G10 base plate", sys = "phmd", module = "phmdgeo.g"
BASE comment = "a bottom of TPC coolant structure      ", sys = "btof", module = "btofgeo1:6.g"
BASS comment = "a single TOF Slat Assembly (slat+PMT+base)", sys = "btof", module = "btofgeo1:6.g"
BBCA comment = "one BBC Annulus", sys = "bbc", module = "bbcmgeo.g"
BBCM comment = "one BBC East or West", sys = "bbc", module = "bbcmgeo.g"
BCCV comment = "a  Ctb optical ConVerter", sys = "btof", module = "btofgeo1:4.g"
BCCV comment = "a  Ctb optical ConVerter", sys = "btof", module = "btofgeo5:6.g"
BCEB comment = "a square G10 board in the CW Base for TOF", sys = "btof", module = "btofgeo2:6.g"
BCEL comment = "a circular G10 board in the CW Base for TOF", sys = "btof", module = "btofgeo2:6.g"
BCEL comment = "a G10 board in the CW Base for TOF", sys = "btof", module = "btofgeo1.g"
BCON comment = "a generic plastic block for various connectors, foam-support-angles, etc......", sys = "btof", module = "btofgeo2:6.g"
BCOO comment = "the cooling rails/loops", sys = "btof", module = "btofgeo1:6.g"
BCOV comment = "a whole TPC cooling channel", sys = "btof", module = "btofgeo1:6.g"
BCPM comment = "a PhotoMultiplier Tube (same for CTB and TOF)", sys = "btof", module = "btofgeo1:6.g"
BCSB comment = "the active trigger scintillator SLAB for tof", sys = "btof", module = "btofgeo1:6.g"
BCSK comment = "a CTB Linear Base tube", sys = "btof", module = "btofgeo1:6.g"
BFEE comment = "a G10 discriminator/CW control board for TOF", sys = "btof", module = "btofgeo1:6.g"
BGMT comment = "the mixture gas box in tray that change the hc box into slim", sys = "btof", module = "btofgeo2:6.g"
BLEM comment = "a Lemo connector on the FEE boards", sys = "btof", module = "btofgeo3:6.g"
BMAA comment = "a b1ox for a 4wide AND 5wide phi column of TOF Scintillators", sys = "btof", module = "btofgeo2:6.g"
BMTC comment = "the Main Tray Cavity filled with MANY details for CTB", sys = "btof", module = "btofgeo1:6.g"
BMTD comment = "a 5wide phi column of TOF Scintillators", sys = "btof", module = "btofgeo2:6.g"
BMTD comment = "a phi column of TOF Scintillators", sys = "btof", module = "btofgeo1.g"
BMTM comment = "the Main Tray cavity divisions Mother volume for TOF", sys = "btof", module = "btofgeo1.g"
BORD comment = "carbon", sys = "rich", module = "richgeo.g"
BPIP comment = "the Long Pipe for the cooling loop", sys = "btof", module = "btofgeo1:6.g"
BPIQ comment = "the Short Pipe for the cooling loop", sys = "btof", module = "btofgeo2:6.g"
BPLA comment = "the plastic angle pieces that hold the upper foam supports...", sys = "btof", module = "btofgeo2:6.g"
BPOL comment = "one Bbc POLystyren active scintillator layer", sys = "bbc", module = "bbcmgeo.g"
BRAI comment = "the Rail for the cooling loop", sys = "btof", module = "btofgeo1:6.g"
BRCB comment = "the PCB in the TOFr", sys = "btof", module = "btofgeo2:6.g"
BRDT comment = "the middle part (including innner glass and gas)in the MRPC", sys = "btof", module = "btofgeo2:6.g"
BRFE comment = "the FEE of tofr (run-3)", sys = "btof", module = "btofgeo2:6.g"
BRGR comment = "the GRaphite in the TOFr", sys = "btof", module = "btofgeo2:6.g"
BRHC comment = "the HoneyComb in the TOFr", sys = "btof", module = "btofgeo2:6.g"
BRIG comment = "the Inner Glass in the TOFr", sys = "btof", module = "btofgeo2:6.g"
BRMD comment = "a six channel sys for TOFr", sys = "btof", module = "btofgeo2:6.g"
BRMY comment = "the MYlar in the TOFr", sys = "btof", module = "btofgeo2:6.g"
BROG comment = "the Outer Glass in the TOFr", sys = "btof", module = "btofgeo2:6.g"
BRSG comment = "the sensitive gas layer in the TOFr", sys = "btof", module = "btofgeo2:6.g"
BRTC comment = "the Main Tray Cavity filled with the details for TOFr (run3 or run4)", sys = "btof", module = "btofgeo2:6.g"
BRWG comment = "the WedGe(support) in the TOFr", sys = "btof", module = "btofgeo2:6.g"
BSEC comment = "a sector of CTB/TOF Trigger Barrel Scintillators", sys = "btof", module = "btofgeo1:6.g"
BTFE comment = "the TINO/TDIG boards", sys = "btof", module = "btofgeo6.g"
BTFT comment = "the Foot structure    ( Material  Aluminium )", sys = "btof", module = "btofgeo1:6.g"
BTOF comment = "the whole CTF system envelope", sys = "btof", module = "btofgeo1:6.g"
BTOH comment = "a half of trigger system (west-east)", sys = "btof", module = "btofgeo1:6.g"
BTRA comment = "one full tray plus supporting structure for CTB/TOF", sys = "btof", module = "btofgeo1:6.g"
BTSK comment = "the outer shell of a TOF CW Base", sys = "btof", module = "btofgeo1:6.g"
BTTC comment = "the Main Tray Cavity filled with MANY details for TOF", sys = "btof", module = "btofgeo1.g"
BTTC comment = "the Main Tray Cavity filled with the details for TOFp", sys = "btof", module = "btofgeo2:3.g"
BTTC comment = "the Main Tray Cavity filled with the details for TOFp", sys = "btof", module = "btofgeo4:6.g"
BUND comment = "Undercarriage support tray - same both for CTB and TOF", sys = "btof", module = "btofgeo1:6.g"
BUPC comment = "the up pcb cover of tofr", sys = "btof", module = "btofgeo2:6.g"
BWAT comment = "tPC cooling water", sys = "btof", module = "btofgeo1:6.g"
BXSA comment = "the active trigger scintillator SLAB for ctb", sys = "btof", module = "btofgeo1:6.g"
BXTR comment = "a Main TRay covering box for CTB or TOF", sys = "btof", module = "btofgeo1:6.g"
BZEL comment = "a Ctb PM electronics", sys = "btof", module = "btofgeo1:6.g"
CALB comment = "EMC Barrel envelope", sys = "calb", module = "calbgeo:2.g"
CAVE comment = "GSTAR cave with subsystem envelopes", sys = "cave", module = "cavegeo.g"
CBTW comment = "the  sys Front Back Plate", sys = "calb", module = "calbgeo:2.g"
CHLV comment = "corresponds to double syss...", sys = "calb", module = "calbgeo:2.g"
CLAD comment = "one CLADding of BPOL active region", sys = "bbc", module = "bbcmgeo.g"
COIL comment = "the main coil mother", sys = "magp", module = "magpgeo.g"
CPHI comment = "corresponds to a single", sys = "calb", module = "calbgeo:2.g"
CSCI comment = "a scintillator layer.", sys = "calb", module = "calbgeo:2.g"
CSDA comment = "Al with sensitive gas volume", sys = "calb", module = "calbgeo:2.g"
CSHI comment = "a sensiteve Ar/CO2 box", sys = "calb", module = "calbgeo:2.g"
CSMB comment = "the back first (last) Al rib", sys = "calb", module = "calbgeo:2.g"
CSMC comment = "the front first (last) Al rib", sys = "calb", module = "calbgeo:2.g"
CSMD comment = "the shower maximum detector envelope", sys = "calb", module = "calbgeo:2.g"
CSME comment = "the part of CSDA Al box with Ar/CO2 sensiteve gas", sys = "calb", module = "calbgeo:2.g"
CSMG comment = "G10 front back plate", sys = "calb", module = "calbgeo:2.g"
CSUP comment = "a super layer with few layers inside", sys = "calb", module = "calbgeo:2.g"
upstream", module = "upstgeo.g"
DUMM comment = "the dummy object", sys = "dumm", module = "dummgeo.g"
upstream", module = "upstgeo.g"
upstream", module = "upstgeo.g"
DZER comment = "the D0 yoke", sys = "quad", module = "quadgeo.g"
EAGA comment = "half of wheel air volume for  the EndCap", sys = "ecal", module = "ecalgeo.g"
EALP comment = "ALuminium  Plate in calorimeter cell", sys = "ecal", module = "ecalgeo.g"
ECAL comment = "one EMC EndCap wheel", sys = "ecal", module = "ecalgeo.g"
ECGH comment = "air Gap between endcap Half wheels", sys = "ecal", module = "ecalgeo.g"
ECHC comment = "steel EndCap Half Cover", sys = "ecal", module = "ecalgeo.g"
ECVO comment = "one of EndCap Volume with megatiles and radiators", sys = "ecal", module = "ecalgeo.g"
EFLP comment = "First Aluminium plate", sys = "ecal", module = "ecalgeo.g"
EHMS comment = "sHower Max Strip", sys = "ecal", module = "ecalgeo.g"
ELED comment = "lead absorber Plate", sys = "ecal", module = "ecalgeo.g"
EMGT comment = "a megatile EM section", sys = "ecal", module = "ecalgeo.g"
EMOD comment = "one sys  of the EM EndCap", sys = "ecal", module = "ecalgeo.g"
EMSS comment = "steel support of the EndCap", sys = "ecal", module = "ecalgeo.g"
EPER comment = "a EM subsection period (super layer)", sys = "ecal", module = "ecalgeo.g"
EPSB comment = "Projectile Stainless steel Bar", sys = "ecal", module = "ecalgeo.g"
ERAD comment = "radiator", sys = "ecal", module = "ecalgeo.g"
ERCM comment = "stainless steel tie Rod in CaloriMeter sections", sys = "ecal", module = "ecalgeo.g"
ERSM comment = "stainless steel tie Rod in Shower Max", sys = "ecal", module = "ecalgeo.g"
ESCI comment = "the active scintillator (polystyren) layer ", sys = "ecal", module = "ecalgeo.g"
ESEC comment = "a single EM section", sys = "ecal", module = "ecalgeo.g"
ESHM comment = "the SHower Max  section", sys = "ecal", module = "ecalgeo.g"
ESPL comment = "one of the Shower max  PLanes", sys = "ecal", module = "ecalgeo.g"
ESSP comment = "Stainless Steel  back Plate", sys = "ecal", module = "ecalgeo.g"
ETAR comment = "one CELL of scintillator, fiber and plastic", sys = "ecal", module = "ecalgeo.g"
EXGT comment = "the G10 layer in the Shower Max ", sys = "ecal", module = "ecalgeo.g"
EXSG comment = "the Shower max  Gap for scintillator strips", sys = "ecal", module = "ecalgeo.g"
FALP comment = "ALuminium  Plate in shower max", sys = "fpd", module = "fpdmgeo.g"
FALU comment = "Aluminium Base Cell", sys = "fpd", module = "fpdmgeo3.g"
FBAS comment = "Steel Base Plate", sys = "fpd", module = "fpdmgeo3.g"
FBOX comment = "one Pb-Glass fpd detector", sys = "fpd", module = "fpdmgeo1:3.g"
FDMO comment = "the mother of an individual two-layer disk assembly (wafers and cooling)", sys = "fstd", module = "fstdgeo.g"
FDMS comment = "a division within an individual disk", sys = "fstd", module = "fstdgeo.g"
FDMW comment = "the mother wedge, housing plate, sensor  and chips", sys = "fstd", module = "fstdgeo.g"
FDSC comment = "the readout Chip", sys = "fstd", module = "fstdgeo.g"
FDSW comment = "the Silicon Wafer (all active)", sys = "fstd", module = "fstdgeo.g"
FDTP comment = "the AlN Thermal Plate", sys = "fstd", module = "fstdgeo.g"
FDWD comment = "the water duct made of carbon composite", sys = "fstd", module = "fstdgeo.g"
FDWW comment = "the water inside the carbon duct", sys = "fstd", module = "fstdgeo.g"
FEAC comment = "Steel Enclosure", sys = "fpd", module = "fpdmgeo3.g"
FEBC comment = "Air square hole", sys = "fpd", module = "fpdmgeo3.g"
FECC comment = "Steel distancer", sys = "fpd", module = "fpdmgeo3.g"
FEDC comment = "Steel Enclosure part on south", sys = "fpd", module = "fpdmgeo3.g"
FEEC comment = "Steel Enclosure part on north", sys = "fpd", module = "fpdmgeo3.g"
FENC comment = "Steel Enclosure", sys = "fpd", module = "fpdmgeo3.g"
FERC comment = "Air Enclosure part", sys = "fpd", module = "fpdmgeo3.g"
FESC comment = "Air Enclosure part", sys = "fpd", module = "fpdmgeo3.g"
FETC comment = "Air Enclosure part", sys = "fpd", module = "fpdmgeo3.g"
FFCE comment = "the Fildcage Enhanced Support Structure", sys = "ftpc", module = "ftpcgeo:1.g"
FFLP comment = "First Aluminium plate", sys = "fpd", module = "fpdmgeo.g"
FFRA comment = "outermost FC Ring", sys = "ftpc", module = "ftpcgeo:1.g"
FFSL comment = "ceramic holder for fieldcage rings", sys = "ftpc", module = "ftpcgeo:1.g"
FGAM comment = "the mother of the Argon volume", sys = "fgtd", module = "fgtdgeo.g"
FGAS comment = "the FTPC gas volume", sys = "ftpc", module = "ftpcgeo:2.g"
FGFO comment = "the GEM foils", sys = "fgtd", module = "fgtdgeo1.g"
FGGT comment = "the G10 plate", sys = "fgtd", module = "fgtdgeo.g"
FGIS comment = "the inner support or spacer", sys = "fgtd", module = "fgtdgeo1.g"
FGKP comment = "the Kapton layer", sys = "fgtd", module = "fgtdgeo.g"
FGMO comment = "the mother of the Forward GEM detector", sys = "fgtd", module = "fgtdge:2.g"
FGRL comment = "the readout layer", sys = "fgtd", module = "fgtdgeo1.g"
FGRN comment = "a Ring in the GEM detector", sys = "fgtd", module = "fgtdgeo.g"
FGSC comment = "the sensitive area", sys = "fgtd", module = "fgtdgeo:2.g"
FHMS comment = "sHower Max Strip", sys = "fpd", module = "fpdmgeo:3.g"
FIAL comment = "the inner AL-tube of the FTPC", sys = "ftpc", module = "ftpcgeo:2.g"
FIFR comment = "the Al inner flange ring", sys = "ftpc", module = "ftpcgeo.g"
FKWI comment = "the double Kapton window", sys = "ftpc", module = "ftpcgeo1.g"
FKWI comment = "the double Kapton window", sys = "ftpc", module = "ftpcgeo.g"
FLED comment = "lead absorber Plate", sys = "fpd", module = "fpdmgeo.g"
FLGD comment = "one Pb-Glass fpd detector", sys = "fpd", module = "fpdmgeo.g"
FLGF comment = "Lead Glass detector", sys = "fpd", module = "fpdmgeo2.g"
FLGR comment = "Lead Glass detector", sys = "fpd", module = "fpdmgeo:3.g"
FLGT comment = "one PbG Tower", sys = "fpd", module = "fpdmgeo:2.g"
FLXF comment = "Lead Glass detector", sys = "fpd", module = "fpdmgeo3.g"
FMOD comment = "one sys  of the EM EndCap", sys = "fpd", module = "fpdmgeo.g"
FMPT comment = "the insulating plastic tube of the drift-electrode", sys = "ftpc", module = "ftpcgeo:1.g"
FMSS comment = "steel support of the EndCap", sys = "fpd", module = "fpdmgeo.g"
FOAL comment = "the Al drift-electrode", sys = "ftpc", module = "ftpcgeo:1.g"
FPAD comment = "the Pad plane of the FTPC", sys = "ftpc", module = "ftpcgeo:1.g"
FPCT comment = "Photo Cathode", sys = "fpd", module = "fpdmgeo:3.g"
FPDM comment = "one FPD West volume", sys = "fpd", module = "fpdmgeo.g"
FPER comment = "a EM sesection period (super layer)", sys = "fpd", module = "fpdmgeo.g"
FPRB comment = "silicon rubber", sys = "fpd", module = "fpdmgeo.g"
FPSE comment = "a single EM section", sys = "fpd", module = "fpdmgeo.g"
FRCC comment = "the Copper Cooling Layer of the Readout Chamber (Middle)", sys = "ftpc", module = "ftpcgeo:1.g"
FRCE comment = "the Copper Cooling Layer of the Readout Chamber (Ends)", sys = "ftpc", module = "ftpcgeo:1.g"
FREL comment = "the Electronics Layer of the Readout Chamber", sys = "ftpc", module = "ftpcgeo:1.g"
FREO comment = "FREON", sys = "rich", module = "richgeo.g"
FROB comment = "the Box Holes in the Readout Chamber", sys = "ftpc", module = "ftpcgeo:1.g"
FROE comment = "the End Box Holes in the Readout Chamber", sys = "ftpc", module = "ftpcgeo:1.g"
FROL comment = "the Length side Box Holes in the Readout Chamber", sys = "ftpc", module = "ftpcgeo:1.g"
FROM comment = "one sys of the Readout Chamber", sys = "ftpc", module = "ftpcgeo:1.g"
FROP comment = "the Polygon part of the support bar", sys = "ftpc", module = "ftpcgeo:1.g"
FROS comment = "one Ring of Readout syss in the support Structure ", sys = "ftpc", module = "ftpcgeo:1.g"
FROT comment = "the Trapezoid part of the support bar", sys = "ftpc", module = "ftpcgeo:1.g"
FSBA comment = "the Stabilizer for the  inner Support Ring", sys = "ftpc", module = "ftpcgeo:1.g"
FSCI comment = "the active scintillator (polystyren) layer ", sys = "fpd", module = "fpdmgeo.g"
FSEC comment = "a sensitive gas sector", sys = "ftpc", module = "ftpcgeo:1.g"
FSEN comment = "the sensitive gas volume", sys = "ftpc", module = "ftpcgeo:1.g"
FSER comment = "the Support End Ring", sys = "ftpc", module = "ftpcgeo:1.g"
FSHL comment = "a hole the beam of the strut", sys = "fsmo", module = "ftrogeo.g"
FSHM comment = "the SHower Max  section", sys = "fpd", module = "fpdmgeo:1.g"
FSHM comment = "the SHower Max  section", sys = "fpd", module = "fpdmgeo:3.g"
FSMO comment = "the mother of one endcap of FSTD", sys = "fsmo", module = "fstdge:o.g"
FSPG comment = "the inner Support End Ring and the outer support Rings", sys = "ftpc", module = "ftpcgeo:1.g"
FSPI comment = "the Hole of the inner Support End Ring", sys = "ftpc", module = "ftpcgeo:1.g"
FSRA comment = "the outer Support End Ring", sys = "ftpc", module = "ftpcgeo:1.g"
FSRB comment = "the medium Support End Ring", sys = "ftpc", module = "ftpcgeo:1.g"
FSRI comment = "the inner Support Ring", sys = "ftpc", module = "ftpcgeo:1.g"
FSSM comment = "the main Support Stucture", sys = "ftpc", module = "ftpcgeo:1.g"
FSSP comment = "stainless steel  Plate", sys = "fpd", module = "fpdmgeo.g"
FSTC comment = "the central beam of the strut", sys = "fsmo", module = "ftrogeo.g"
FSTL comment = "the flat part of the strut", sys = "fsmo", module = "ftrogeo.g"
FTAR comment = "one CELL of scintillator, fiber and laminated lead", sys = "fpd", module = "fpdmgeo.g"
FTCD comment = "the division of the FTCM", sys = "fsmo", module = "ftrogeo.g"
FTCM comment = "the mother of the core struts and PCBs", sys = "fsmo", module = "ftrogeo.g"
FTIF comment = "the inner flange", sys = "fstd", module = "ftrogeo.g"
FTMO comment = "the mother of the single FTPC RO barrel", sys = "fstd", module = "ftrogeo.g"
FTOF comment = "the outer flange", sys = "fstd", module = "ftrogeo.g"
FTOH comment = "a hole the outer flange", sys = "fstd", module = "ftrogeo.g"
FTOW comment = "one PbG Tower", sys = "fpd", module = "fpdmgeo:3.g"
FTPC comment = "the Forward TPC mother (needed for standalong test only)", sys = "ftpc", module = "ftpcgeo:1.g"
FTPI comment = "the inner PCB", sys = "fsmo", module = "ftrogeo.g"
FTPL comment = "the plank covering the strut", sys = "fsmo", module = "ftrogeo.g"
FTPO comment = "the outer PCB", sys = "fsmo", module = "ftrogeo.g"
FTRM comment = "the rim connected to the inner flange", sys = "fstd", module = "ftrogeo.g"
FTSH comment = "the protective shell", sys = "fsmo", module = "ftrogeo.g"
FUMT comment = "mu metal", sys = "fpd", module = "fpdmgeo:3.g"
FWAL comment = "almunum wrapper", sys = "fpd", module = "fpdmgeo:3.g"
FXFP comment = "SS laminated plate", sys = "fpd", module = "fpdmgeo.g"
FXGT comment = "the G10 layer in the SMax", sys = "fpd", module = "fpdmgeo:3.g"
FXSG comment = "the Shower max  Gap for scintillator strips", sys = "fpd", module = "fpdmgeo.g"
GMBO comment = "the mother of the GEMB detector", sys = "gemb", module = "gembgeo.g"
GMDI comment = "the sensitive volume of the GEM strip detector, layer 1", sys = "gemb", module = "gembgeo.g"
GMGI comment = "a GEM strip detector filled with gas, layer 1", sys = "gemb", module = "gembgeo.g"
GMMI comment = "a GEM strip detector, mylar staff, layer 1", sys = "gemb", module = "gembgeo.g"
GMVI comment = "a GEM strip detector, layer 1", sys = "gemb", module = "gembgeo.g"
HALL comment = "GSTAR building", sys = "hall", module = "cavegeo.g"
HOLE comment = "an oppening in the aluminum frame", sys = "rich", module = "richgeo.g"
HONE comment = "a CARBONIO", sys = "rich", module = "richgeo.g"
IBAA comment = "the vertical post on the balcony (Aluminum)", sys = "ibem", module = "vpddgeo2.g"
IBAB comment = "the diagonal post from the balcony (Aluminum)", sys = "ibem", module = "vpddgeo2.g"
IBAC comment = "vertical parts of the cross post below the I-Beam (Aluminum)", sys = "ibem", module = "vpddgeo2.g"
IBAM comment = "the mother of the whole long ladder", sys = "ist", module = "istbgeo:6:00.g"
IBBC comment = "the horizontal part of the cross post below the I-Beam (Aluminum)", sys = "ibem", module = "vpddgeo2.g"
IBCC comment = "the end caps on the cross post below the I-Beam (Aluminum)", sys = "ibem", module = "vpddgeo2.g"
IBEH comment = "a horizontal IBeam plate", sys = "ibem", module = "vpddgeo:2.g"
IBEM comment = "the IBeam structure beneath the Bell reducer cone", sys = "ibem", module = "vpddgeo:2.g"
IBEV comment = "a vertical IBeam plate", sys = "ibem", module = "vpddgeo:2.g"
IBEW comment = "the first part of the IBeam plate", sys = "ibem", module = "vpddgeo:2.g"
IBLM comment = "the mother of the sensor assembly", sys = "ist", module = "istbgeo:6:00.g"
IBME comment = "the mother of the interconnect of the IST on the WEST side", sys = "ibem", module = "istbgeo1,2,5,6.g"
IBMO comment = "the mother of the ISTB detector", sys = "ist", module = "istbgeo:6:00.g"
IBMW comment = "the mother of the interconnect of the IST on the EAST side", sys = "ist", module = "istbgeo1-2:5-6.g"
IBMY comment = "the mother of the inner IST layer", sys = "ist", module = "istbgeo*.g"
IBMZ comment = "the mother of the outer IST layer", sys = "ist", module = "istbgeo1.g"
IBSA comment = "the vertical post on the balcony (Envelope)", sys = "ibem", module = "vpddgeo2.g"
IBSB comment = "the diagonal post from the balcony (Envelope)", sys = "ibem", module = "vpddgeo2.g"
IBSC comment = "the cross post below the I-Beam (Envelope)", sys = "ibem", module = "vpddgeo2.g"
IBSD comment = "the horizontal plates that hold the pipe-support brackets (Aluminum)", sys = "ibem", module = "vpddgeo2.g"
IBSE comment = "the vertical parts of the pipe-support brackets (Aluminum)", sys = "ibem", module = "vpddgeo2.g"
IBSF comment = "the long threaded rods for X-support of the I-beam", sys = "ibem", module = "vpddgeo2.g"
IBSG comment = "the vertical bolts to the pipe-support brackets", sys = "ibem", module = "vpddgeo2.g"
IBSH comment = "the cross-bolts from the pipe-support brackets to the pipe", sys = "ibem", module = "vpddgeo2.g"
IBSP comment = "the Silicon Sensor Passive Area", sys = "ist", module = "istbgeo00.g"
IBSS comment = "the Silicon Sensor Active Area", sys = "ibem", module = "istbgeo*.g"
IGAL comment = "the active area", sys = "igtd", module = "igtdgeo.g"
IGDO comment = "the mother volume of the individual GEM disks", sys = "igtd", module = "igtdgeo.g"
IGFO comment = "the GEM foils", sys = "igtd", module = "igtdgeo.g"
IGIS comment = "the inner support or spacer", sys = "igtd", module = "igtdgeo.g"
IGMO comment = "the mother volume for the IGTD", sys = "igtd", module = "igtdgeo.g"
IGOS comment = "the outer support or spacer", sys = "igtd", module = "igtdgeo.g"
IGRL comment = "the readout layer", sys = "igtd", module = "igtdgeo.g"
ISCL comment = "the Copper layer on the Kapton hybrid", sys = "ist", module = "istbgeo1.g"
ISCL comment = "the Copper layer on the Kapton hybrid", sys = "ist", module = "istbgeo*.g"
ISCO comment = "the interconnect between the support rings", sys = "ist", module = "istbgeo*.g"
ISKH comment = "the Kapton hybrid", sys = "ist", module = "istbgeo*.g"
ISLA comment = "the large glue layer between Carbon foam and sensor (and sensor and hybrid)", sys = "ist", module = "istbgeo1.g"
ISLB comment = "the small glue layer between hybrid and chip", sys = "ist", module = "istbgeo*.g"
ISRI comment = "the support ring for the layers", sys = "ist", module = "istbgeo*.g"
ISSC comment = "the readout Chip", sys = "ist", module = "istbgeo*.g"
ISTP comment = "the AlN Thermal Plate", sys = "ist", module = "istbgeo.g"
ISTP comment = "the Carbon Foam", sys = "ist", module = "istbgeo*.g"
ISVD comment = "the water inside the carbon duct", sys = "ist", module = "istbgeo.g"
ISWD comment = "the water duct made of carbon composite", sys = "ist", module = "istbgeo.g"
ISXA comment = "the large glue layer between Carbon foam and sensor (and sensor and hybrid)", sys = "ist", module = "istbgeo*.g"
ITSP comment = "the Inner Tracker SuPport cone mother volume", sys = "scon", module = "itspgeo.g"
MAGP comment = "the magnet mother", sys = "magp", module = "magpgeo.g"
MBAR comment = "a single return yoke bar", sys = "magp", module = "magpgeo.g"
MCSE comment = "a single barrel coil", sys = "magp", module = "magpgeo.g"
MGMT comment = "the magnet mother", sys = "quad", module = "quadgeo.g"
MMRP comment = "a Main TRay covering box for MRPC", sys = "mutd", module = "mutdgeo:3.g"
MMTC comment = "the Main Tray Cavity filled with the details for CTB", sys = "mutd", module = "mutdgeo:3.g"
MPCV comment = "the coil cavity in the pole-tip (filled with cables ?)", sys = "magp", module = "magpgeo.g"
MPMT comment = "a Main TRay covering box for PMT", sys = "mutd", module = "mutdgeo:3.g"
MPTV comment = "the magnet pole-tip volume", sys = "magp", module = "magpgeo.g"
MRET comment = "Magnet RETurn Yoke", sys = "magp", module = "magpgeo.g"
MRGV comment = "the Magnet Return rinG", sys = "magp", module = "magpgeo.g"
MSEC comment = "a sector containing a single retun bar", sys = "magp", module = "magpgeo.g"
MTCL comment = "tRIM COIL Volume (filled with aluminum)", sys = "magp", module = "magpgeo.g"
MTRA comment = "one full tray plus supporting structure for CTB/TOF", sys = "mutd", module = "mutdgeo:3.g"
MUSC comment = "a sector of MUON Trigger Barrel Scintillators", sys = "mutd", module = "mutdgeo:3.g"
MUTD comment = "the muon detector mother", sys = "mutd", module = "mutdgeo:3.g"
MXSA comment = "the active trigger scintillator SLAB for ctb", sys = "mutd", module = "mutdgeo:3.g"
MXTR comment = "a Main TRay covering box for CTB or TOF", sys = "mutd", module = "mutdgeo:3.g"
OQUA comment = "e me scelto per labellare il quarzo opaco", sys = "rich", module = "richgeo.g"
OQUF comment = "FRAME QUARZO OPACO", sys = "rich", module = "richgeo.g"
PBPT comment = "pb plate", sys = "fpd", module = "fpdmgeo1:3.g"
PCBA comment = "the chamber PCB", sys = "phmd", module = "phmdgeo.g"
PDCU comment = "The outer cell in the PMD", sys = "phmd", module = "phmdgeo.g"
PDGS comment = "The inner cell in the PMD", sys = "phmd", module = "phmdgeo.g"
PFEA comment = "the iron plates for different syss", sys = "phmd", module = "phmdgeo.g"
PFLO comment = "the 1st set of flanges at ~3.9 m from IR", sys = "pipe", module = "pipegeo.g"
PFLT comment = "the 2nd set of flanges at ~4.2 m from IR", sys = "pipe", module = "pipegeo.g"
PHCA comment = "the detector made in air", sys = "phmd", module = "phmdgeo.g"
PHMD comment = "the PMD box volume and fill with air", sys = "phmd", module = "phmdgeo.g"
PHMS comment = "the PMD sector volume - 1/3rd of PHMD", sys = "phmd", module = "phmdgeo.g"
PHSR comment = "a detector box made in air", sys = "phmd", module = "phmdgeo.g"
PIPB comment = "the beam pipe Bell reducing section", sys = "pipe", module = "pipegeo.g"
PIPC comment = "the Central Beam PIPe Volume", sys = "pipe", module = "pipegeo00.g"
PIPC comment = "the Central Beam PIPe Volume", sys = "pipe", module = "pipegeo.g"
PIPE comment = "the STAR beam pipe mother volume", sys = "pipe", module = "pipegeo*00.g"
PIPH comment = "the Large diameter Pipe before the beam pipes split", sys = "zcal", module = "zcalgeo.g"
PIPI comment = "Steel pipe of the Bellow section", sys = "pipe", module = "pipegeo.g"
PIPJ comment = "the final beam Pipes", sys = "zcal", module = "zcalgeo.g"
PIPO comment = "Steel pipe from Be to 1st flanges", sys = "pipe", module = "pipegeo.g"
PIPS comment = "5 inch OD steel beam pipe starting ~4.5 m from IR", sys = "pipe", module = "pipegeo.g"
PIPT comment = "short Steel pipe of the transition section", sys = "pipe", module = "pipegeo.g"
PLAC comment = "the active layer of the ladder", sys = "pixel", module = "pixlgeo*.g"
PLAT comment = "the End Plate of the large dia. Pipe", sys = "zcal", module = "zcalgeo.g"
PLMI comment = "the mother of a silicon ladder", sys = "pixel", module = "pixlgeo00.g"
PLMO comment = "the mother of the silicon ladder", sys = "pixel", module = "pixlgeo*.g"
PLPS comment = "the passive layer of the ladder", sys = "pixel", module = "pixlgeo00.g"
PLPS comment = "the passive layer of the ladder", sys = "pixel", module = "pixlgeo*.g"
PLVA comment = "the Vacuum Volume of the beam pipe holes in the end plate", sys = "zcal", module = "zcalgeo.g"
PMDA comment = "a detector box made in aluminium", sys = "phmd", module = "phmdgeo.g"
PPBA comment = "The lead plates for different syss", sys = "phmd", module = "phmdgeo.g"
PRIB comment = "a Rib of Steel Bellows", sys = "pipe", module = "pipegeo.g"
PRID comment = "a Rib section", sys = "pipe", module = "pipegeo.g"
PRIS comment = "the Bellow Steel Rib Set", sys = "pipe", module = "pipegeo.g"
PSEC comment = "a group of ladders", sys = "pixel", module = "pixlgeo*.g"
PSLD comment = "the svt beampipe shield", sys = "pipe", module = "pipegeo.g"
PSTR comment = "one pseudo-cell", sys = "phmd", module = "phmdgeo.g"
upstream", module = "upstgeo.g"
upstream", module = "upstgeo.g"
upstream", module = "upstgeo.g"
upstream", module = "upstgeo.g"
PVAB comment = "its cavity", sys = "pipe", module = "pipegeo.g"
PVAC comment = "the Vacuum Volume of Be section of pipe", sys = "pipe", module = "pipegeo*.g"
upstream", module = "upstgeo.g"
upstream", module = "upstgeo.g"
upstream", module = "upstgeo.g"
PVAH comment = "the Vacuum Volume of the large diameter pipe", sys = "zcal", module = "zcalgeo.g"
PVAI comment = "its cavity", sys = "pipe", module = "pipegeo.g"
PVAJ comment = "the Vacuum Volume of the final beam pipes", sys = "zcal", module = "zcalgeo.g"
PVAO comment = "its cavity", sys = "pipe", module = "pipegeo.g"
PVAS comment = "its cavity", sys = "pipe", module = "pipegeo.g"
PVAT comment = "its cavity", sys = "pipe", module = "pipegeo.g"
PWRP comment = "the beampipe wrap of Kapton and aluminum", sys = "pipe", module = "pipegeo.g"
PXBX comment = "the exoskeleton of the beampipe", sys = "pixel", module = "pixlgeo*.g"
PXLA comment = "the mother of a layer", sys = "pixel", module = "pixlgeo00.g"
PXMO comment = "the mother of the pixel detector volumes", sys = "pixel", module = "pixlgeo0*.g"
QCAL comment = "the Zero degree calorimeter", sys = "zcal", module = "zcalgeo.g"
QDIV comment = "one section/layer of the Quartz Calorimeter", sys = "zcal", module = "zcalgeo.g"
QONE comment = "the Q1 yoke", sys = "quad", module = "quadgeo.g"
QSCI comment = "a sensitive Fiber layer", sys = "zcal", module = "zcalgeo.g"
QTHR comment = "the Q3 yoke", sys = "quad", module = "quadgeo.g"
QTWO comment = "the Q2 yoke", sys = "quad", module = "quadgeo.g"
QUAR comment = "da me scelto per labellare il quarzo", sys = "rich", module = "richgeo.g"
RCSI comment = "Cesium Iodide", sys = "rich", module = "richgeo.g"
RGAP comment = "METANOL gap", sys = "rich", module = "richgeo.g"
RICH comment = "just an aluminum box", sys = "rich", module = "richgeo.g"
SAGP comment = "the Silver-Palladium layer", sys = "svt", module = "svttgeo*.g"
SAKM comment = "the beampipe support aluminum kinematic mount", sys = "svt", module = "scongeo*.g"
SALM comment = "the aluminum shield mesh", sys = "svt", module = "svttgeo*.g"
SAPC comment = "the core (Epoxy) of the adc board appendice", sys = "ssd", module = "sisdgeo*.g"
SAPP comment = "the mother volume of the adc board appendice", sys = "ssd", module = "sisdgeo*.g"
SAPS comment = "the side shell (Carbon) of the adc board appendice", sys = "ssd", module = "sisdgeo*.g"
SAPT comment = "the top-bottom shell (Carbon) of the adc board appendice", sys = "ssd", module = "sisdgeo*.g"
SBCH comment = "the horizontal branch of the DELRIN cross", sys = "ssd", module = "sisdgeo*.g"
SBCR comment = "the cutout in the beampipe support G10 ring", sys = "svt", module = "svttgeo1*.g"
SBCV comment = "the vertical branch of the DELRIN cross", sys = "ssd", module = "sisdgeo*.g"
SBER comment = "the Berillium wafer carrier rails", sys = "svt", module = "svttgeo*.g"
SBFH comment = "the horizontal branch of the Alumimium cross", sys = "ssd", module = "sisdgeo3:6.g"
SBFV comment = "the vertical branch of the Alumimium cross", sys = "ssd", module = "sisdgeo3:6.g"
SBMI comment = "the inner beampipe support mounting block", sys = "svt", module = "scongeo:6.g"
SBMM comment = "the beampipe support mounting mother volume", sys = "svt", module = "scongeo:6.g"
SBMO comment = "the outer beampipe support mounting block", sys = "svt", module = "scongeo:6.g"
SBOI comment = "the Berillia layer", sys = "svt", module = "svttgeo10:6.g"
SBRG comment = "the bracket joining the end rings", sys = "svt", module = "svttgeo10:6.g"
SBRI comment = "the bracket which joins the rings", sys = "svt", module = "svttgeo10:6.g"
SBRL comment = "the ceramic roller supporting the beampipe", sys = "svt", module = "scongeo:6.g"
SBRM comment = "a the mother of a single bracket joining the end rings", sys = "svt", module = "svttgeo10:6.g"
SBRX comment = "the stainless steel roller axis", sys = "svt", module = "scongeo:6.g"
SBSP comment = "the beampipe support mother volume", sys = "svt", module = "scongeo:6.g"
SBSR comment = "the beampipe support G10 ring", sys = "svt", module = "scongeo:6.g"
SBWC comment = "the bracket connecting the water manifold to the cone", sys = "svt", module = "svttgeo10:6.g"
SCAL comment = "the aluminization on the mylar wrap around the support cone", sys = "scon", module = "itspgeo:6.g"
SCBL comment = "the bundle of cables going from PCBs to manifolds", sys = "svt", module = "svttgeo10:6.g"
SCBM comment = "the mother for the bundle of cables going from PCBs", sys = "svt", module = "svttgeo10:6.g"
SCKM comment = "the cutout in the aluminum kinematic mount", sys = "svt", module = "scongeo:6.g"
SCMP comment = "the mounting plate inserted in the cones.", sys = "ssd", module = "sisdgeo1:6.g"
SCMY comment = "a mylar wrap around the support cone", sys = "scon", module = "itspgeo:6.g"
SCON comment = "the Silicon tracker supporting cone mother volume", sys = "scon", module = "scongeo:6.g"
SCRW comment = "the screw which attaches the end ring to the end ring bracket", sys = "svt", module = "svttgeo10:6.g"
SCVB comment = "the base plate of the V-shape piece", sys = "ssd", module = "sisdgeo1:6.g"
SCVM comment = "the mother volume of the V-shape piece", sys = "ssd", module = "sisdgeo1:6.g"
SCVS comment = "the side plate of the V-shape piece", sys = "ssd", module = "sisdgeo1:6.g"
SDYE comment = "the ic chip on the hybrid", sys = "svt", module = "svttgeo10:6.g"
SECA comment = "the cable on the electronics carrier", sys = "svt", module = "svttgeo10:6.g"
SELE comment = "the electronics mother volume", sys = "svt", module = "svttgeo10:6.g"
SFAA comment = "the A128C chip", sys = "ssd", module = "sisdgeo1:6.g"
SFAB comment = "the big volume of the adc board", sys = "ssd", module = "sisdgeo1:6.g"
SFAM comment = "the mother volume of the adc board", sys = "ssd", module = "sisdgeo1:6.g"
SFAS comment = "the small volume of the adc board", sys = "ssd", module = "sisdgeo1:6.g"
SFCB comment = "the big part of the second connection board", sys = "ssd", module = "sisdgeo1:6.g"
SFCF comment = "the carbon fiber structure container", sys = "ssd", module = "sisdgeo:6.g"
SFCM comment = "the mother volume of the second connection board", sys = "ssd", module = "sisdgeo1:6.g"
SFCO comment = "the connection board (rectangular with Hirose connectors)", sys = "ssd", module = "sisdgeo1:6.g"
SFCP comment = "the cooling pipe", sys = "ssd", module = "sisdgeo:6.g"
SFCS comment = "the big part of the second connection board", sys = "ssd", module = "sisdgeo1:6.g"
SFCT comment = "the carbon fiber tube", sys = "ssd", module = "sisdgeo:6.g"
SFCW comment = "the water cylinder in the cooling pipe", sys = "ssd", module = "sisdgeo:6.g"
SFCX comment = "the carbon fiber tube", sys = "ssd", module = "sisdgeo:6.g"
SFDM comment = "the mother of the detectors", sys = "ssd", module = "sisdgeo1:6.g"
SFEB comment = "the big bus elbow", sys = "ssd", module = "sisdgeo1:6.g"
SFED comment = "the watrer in the bundle of pipes going to manifolds", sys = "svt", module = "svttgeo4:6.g"
SFES comment = "the small bus elbow", sys = "ssd", module = "sisdgeo2:6.g"
SFFK comment = "horizontal part of the ladder skeleton carbon base", sys = "ssd", module = "sisdgeo1:6.g"
SFFL comment = "titled part of the ladder skeleton carbon base", sys = "ssd", module = "sisdgeo1:6.g"
SFFX comment = "the flex", sys = "ssd", module = "sisdgeo1:6.g"
SFKF comment = "the first part of the kapton flex circuit", sys = "ssd", module = "sisdgeo1:6.g"
SFKK comment = "horizontal part of the kapton film under the ladder base", sys = "ssd", module = "sisdgeo1:6.g"
SFKL comment = "titled part of the kpaton film under the ladder base", sys = "ssd", module = "sisdgeo1:6.g"
SFKS comment = "the second part of the kapton flex circuit", sys = "ssd", module = "sisdgeo1:6.g"
SFLA comment = "the long part of the bus cable linking the syss to the connection board", sys = "ssd", module = "sisdgeo1:6.g"
SFLB comment = "the part of the long bus cable on the connection board", sys = "ssd", module = "sisdgeo1:6.g"
SFLC comment = "the part of the long bus cable on the connection board up to the connector", sys = "ssd", module = "sisdgeo1:6.g"
SFLM comment = "the mother of the ladder", sys = "ssd", module = "sisdgeo1:6.g"
SFLR comment = "the floor", sys = "shield", module = "shldgeo.g"
SFLT comment = "(half) the top corner of the triangular ladder skeleton", sys = "ssd", module = "sisdgeo1:6.g"
SFLU comment = "(half) the side corner of the triangular ladder skeleton", sys = "ssd", module = "sisdgeo1:6.g"
SFMO comment = "the mother of all Silicon Strip Detector volumes", sys = "ssd", module = "sisdgeo1:6.g"
SFPB comment = "the ladder end outside mechanical part (rectangle with g10)", sys = "ssd", module = "sisdgeo1:6.g"
SFPI comment = "the pions", sys = "ssd", module = "sisdgeo1:6.g"
SFPJ comment = "the base of the pions", sys = "ssd", module = "sisdgeo1:6.g"
SFPR comment = "the ladder end inside mechanical part (prism with g10 with half density)", sys = "ssd", module = "sisdgeo1:6.g"
SFRA comment = "the hybrid stiffneer", sys = "ssd", module = "sisdgeo1:6.g"
SFRS comment = "two supports of the hybrid stiffneer (piece of it)", sys = "ssd", module = "sisdgeo1:6.g"
SFSD comment = "the strip detector", sys = "ssd", module = "sisdgeo1:6.g"
SFSL comment = "the Silicon of the strip detector", sys = "ssd", module = "sisdgeo5.g"
SFSM comment = "the mother of the ladder struct.", sys = "ssd", module = "sisdgeo:6.g"
SFSS comment = "the subvolume of the mother struct.", sys = "ssd", module = "sisdgeo.g"
SFSW comment = "a single wafer container", sys = "ssd", module = "sisdgeo1:6.g"
SGLA comment = "the insulating glass layer", sys = "svt", module = "svttgeo10:6.g"
SGRA comment = "the graphite/epoxy support cone", sys = "scon", module = "itspgeo:6.g"
SHBI comment = "the back iron slab", sys = "shield", module = "shldgeo.g"
SHBK comment = "the upper FTPC support top block", sys = "support", module = "supogeo1.g"
SHBK comment = "the upper FTPC support top block", sys = "support", module = "supogeo.g"
SHBR comment = "the upper FTPC support top bar", sys = "support", module = "supogeo1.g"
SHBS comment = "the shield base", sys = "shield", module = "shldgeo.g"
SHFI comment = "the forward iron slab", sys = "shield", module = "shldgeo.g"
SHFX comment = "the upper FTPC support fixture plate", sys = "support", module = "supogeo1.g"
SHLA comment = "the water hose layer for cone 3 (closer to vertex)", sys = "scon", module = "svttgeo10:6.g"
SHLB comment = "the water hose layer cone 4 (further from vertex)", sys = "scon", module = "svttgeo10:6.g"
SHLD comment = "the shield mother volume in the STAR cave", sys = "shield", module = "shldgeo.g"
SHLS comment = "the lateral slab", sys = "shield", module = "shldgeo.g"
SHMA comment = "a single mother volume for a water hose on the cone 3", sys = "scon", module = "svttgeo10:6.g"
SHMB comment = "a single mother volume for a water hose on the cone 4", sys = "scon", module = "svttgeo10:6.g"
SHOL comment = "the hole in the forward iron slab", sys = "shield", module = "shldgeo.g"
SHPT comment = "the upper FTPC support main plate", sys = "support", module = "supogeo1.g"
SHRL comment = "the upper FTPC support rail", sys = "support", module = "supogeo1.g"
SHST comment = "the upper FTPC support stabilizers", sys = "support", module = "supogeo1.g"
SHWA comment = "the water in the hose", sys = "scon", module = "svttgeo10:6.g"
SHXT comment = "one Single HeXagonal Tile", sys = "bbc", module = "bbcmgeo.g"
SIES comment = "the volume to hold inner endring screws", sys = "svt", module = "svttgeo10:6.g"
SIRP comment = "the SVT inner end ring polycone (overlaps tube)", sys = "svt", module = "svttgeo10:6.g"
SIRT comment = "the SVT inner end ring tube", sys = "svt", module = "svttgeo11:6.g"
SISH comment = "the inner shield cylinder", sys = "svt", module = "svttgeo10:6.g"
SISM comment = "the mother volume division for the inner end ring screws", sys = "svt", module = "svttgeo10:6.g"
SITB comment = "the inner transition board (small r)", sys = "svt", module = "svttgeo10:6.g"
SLBL comment = "the lower FTPC support bolt", sys = "support", module = "supogeo1.g"
SLDI comment = "a ladder volume", sys = "svt", module = "svttgeo10:6.g"
SLEN comment = "the lower FTPC support end block", sys = "support", module = "supogeo1.g"
SLFX comment = "the lower FTPC support fixture plate", sys = "support", module = "supogeo1.g"
SLHD comment = "the lower FTPC support head plate (mounted to TPC)", sys = "support", module = "supogeo1.g"
SLRL comment = "the lower FTPC support rail", sys = "support", module = "supogeo1.g"
SLSD comment = "a single ladder mother (sector of tube)", sys = "svt", module = "svttgeo10:6.g"
SLWL comment = "the lower FTPC support side wall", sys = "support", module = "supogeo1.g"
SLXW comment = "the lower FTPC support cross wall", sys = "support", module = "supogeo1.g"
SLYD comment = "a single SVT layer ", sys = "svt", module = "svttgeo10:6.g"
SMRD comment = "the aluminum rod carrying the beampipe support", sys = "svt", module = "scongeo:6.g"
SMRD comment = "the aluminum rod carrying the beampipe support", sys = "svt", module = "svttgeo.g"
SOER comment = "the SVT outer end ring", sys = "svt", module = "svttgeo10:6.g"
SOES comment = "the volume to hold outer endring screws", sys = "svt", module = "svttgeo10:6.g"
SOSH comment = "the separation shield cylinder", sys = "svt", module = "svttgeo10:6.g"
SOSM comment = "the mother volume division for the outer end ring screws", sys = "svt", module = "svttgeo10:6.g"
SOTB comment = "the outer transition board (large r)", sys = "svt", module = "svttgeo10:6.g"
SOUM comment = "the mother of the array of the outer shileding support tubes", sys = "svt", module = "svttgeo10:6.g"
SOUR comment = "the outer shileding support tubes (rods)", sys = "svt", module = "svttgeo10:6.g"
SPAC comment = "e Spacers (quarz cylinders)", sys = "rich", module = "richgeo.g"
SPCB comment = "the G10 PCB", sys = "svt", module = "svttgeo10:6.g"
SPLS comment = "the plastic walls of the bundle of pipes going to manifolds", sys = "svt", module = "svttgeo10:6.g"
SRHC comment = "the roha cell wafer support", sys = "svt", module = "svttgeo10:6.g"
SRIC comment = "sensitive part of the whole RICH ... full of Methane", sys = "rich", module = "richgeo.g"
SROD comment = "the SVT Be support rod", sys = "svt", module = "svttgeo1:6.g"
SSBB comment = "the Big part of the aluminium plate linking the ladder to the sector", sys = "ssd", module = "sisdgeo1:6.g"
SSBS comment = "the small part of the aluminium plate linking the ladder to the sector", sys = "ssd", module = "sisdgeo1:6.g"
SSID comment = "a non-sensitive left-right border of the wafer", sys = "svt", module = "svttgeo10:6.g"
SSIR comment = "a non-sensitive up-down border of the wafer", sys = "svt", module = "svttgeo6.g"
SSLB comment = "the linking (sector to the cone) box", sys = "ssd", module = "sisdgeo1:6.g"
SSLT comment = "the linking (sector to the cone) tube", sys = "ssd", module = "sisdgeo1:6.g"
SSRS comment = "the side of the small rib", sys = "ssd", module = "sisdgeo1:6.g"
SSRT comment = "the top of the side rib", sys = "ssd", module = "sisdgeo1:6.g"
SSSH comment = "the separation shield cylinder", sys = "svt", module = "svttgeo10:6.g"
SSSS comment = "the side of the small sector", sys = "ssd", module = "sisdgeo1:6.g"
SSST comment = "the top of the small sector", sys = "ssd", module = "sisdgeo6.g"
STAB comment = "the Berillium wafer carrier end tabs", sys = "svt", module = "svttgeo1:6.g"
STAC comment = "the copper part of the twin-ax cable layer", sys = "scon", module = "svttgeo10:6.g"
STAP comment = "the plastic part of the twin-ax cable layer (guess polyethylene)", sys = "scon", module = "itspgeo:6.g"
STLI comment = "the wafer pack container", sys = "svt", module = "svttgeo10:6.g"
STRA comment = "a trapezoid of triangular shape", sys = "svt", module = "svttgeo10:6.g"
STRU comment = "the Berillium struts between the wafer carrier rails", sys = "svt", module = "svttgeo3:6.g"
STSI comment = "a single waver container", sys = "svt", module = "svttgeo10:6.g"
SUPH comment = "the upper FTPC support mother volume", sys = "support", module = "supogeo1.g"
SUPL comment = "the lower FTPC support mother volume", sys = "support", module = "supogeo1.g"
SUPO comment = "the FTPC support mother volume", sys = "support", module = "supogeo1.g"
SVTD comment = "an active wafer volume", sys = "svt", module = "svttgeo10:6.g"
SVTT comment = "the mother of all SVT volumes", sys = "svt", module = "svttgeo10:6.g"
SWCH comment = "the Be top and bottom of the water channel", sys = "svt", module = "svttgeo10:6.g"
SWCM comment = "a single bracket mother between mani and cone", sys = "svt", module = "svttgeo10:6.g"
SWCS comment = "the Be side of the water channel", sys = "svt", module = "svttgeo10:6.g"
SWCW comment = "the water channel water (probably Evian?)", sys = "svt", module = "svttgeo10:6.g"
SWHO comment = "a water hose", sys = "scon", module = "svttgeo10:6.g"
SWMB comment = "the water manifold bottom piece (small r)", sys = "svt", module = "svttgeo10:6.g"
SWMM comment = "the water manifold mother", sys = "svt", module = "svttgeo10:6.g"
SWMS comment = "the water manifold side pieces", sys = "svt", module = "svttgeo10:6.g"
SWMT comment = "the water manifold top piece (big r)", sys = "svt", module = "svttgeo10:6.g"
SWMW comment = "the water in the water manifold", sys = "svt", module = "svttgeo10:6.g"
SWRP comment = "an approximation of water in the circular pipe, a rectangular one", sys = "svt", module = "svttgeo10:6.g"
SXAI comment = "a first piece (A) of the bracket between mani and cone (X)", sys = "svt", module = "svttgeo10:6.g"
SXBI comment = "a second piece (B) of the bracket between mani and cone (X)", sys = "svt", module = "svttgeo10:6.g"
SXRL comment = "the mother of the circular water pipes", sys = "svt", module = "svttgeo10:6.g"
SYRU comment = "the  wall of the water pipe", sys = "svt", module = "svttgeo10:6.g"
TAEC comment = "part of the heat shield for the PC boards", sys = "tpc", module = "tpcegeo1.g"
TALC comment = "part of the heat shield for the PC boards", sys = "tpc", module = "tpcegeo1.g"
TCEX comment = "part of the G10 for the PC boards", sys = "tpc", module = "tpcegeo1.g"
TCRX comment = "part of the G10 for the PC boards", sys = "tpc", module = "tpcegeo1.g"
TESS comment = "a division of endcap volume corresponding to one supersector", sys = "tpc", module = "tpcegeo1.g"
THLA comment = "part of a hole for PC boards", sys = "tpc", module = "tpcegeo1.g"
THOL comment = "part of a hole for PC boards", sys = "tpc", module = "tpcegeo1.g"
THRA comment = "part of a hole for PC boards", sys = "tpc", module = "tpcegeo1.g"
THXM comment = "on Triple HeXagonal", sys = "bbc", module = "bbcmgeo.g"
TIAG comment = "an air gap in inner sector aluminum structure", sys = "tpc", module = "tpcegeo1.g"
TIAL comment = "the inner Aluminum cylinder", sys = "tpc", module = "tpcegeo1.g"
TIFC comment = "the Inner Field Cage placed in TPC", sys = "tpc", module = "tpcegeo1.g"
TIKA comment = "the kapton film of the inner field cage", sys = "tpc", module = "tpcegeo1.g"
TINX comment = "the inner nomex structure", sys = "tpc", module = "tpcegeo1.g"
TMAN comment = "aluminum water manifold", sys = "tpc", module = "tpcegeo1.g"
TMEA comment = "a double sensitive layer around gating grid", sys = "tpc", module = "tpcegeo1.g"
TMSE comment = "a single sensitive volume", sys = "tpc", module = "tpcegeo1.g"
TMWC comment = "a wire chamber volume with both gated and sensitive volumes", sys = "tpc", module = "tpcegeo1.g"
TOAD comment = "Adhesive layer", sys = "tpc", module = "tpcegeo1.g"
TOAE comment = "extra aluminum supports in the air opennings", sys = "tpc", module = "tpcegeo1.g"
TOFC comment = "outer field cage - fill it with insulating gas already", sys = "tpc", module = "tpcegeo1.g"
TOFC comment = "outer field cage - fill it with insulating gas already", sys = "tpc", module = "tpcegeo2.g"
TOFS comment = "the Outer Field Cage structure", sys = "tpc", module = "tpcegeo1.g"
TOHA comment = "Honeycomb/Adhesive mixture", sys = "tpc", module = "tpcegeo1.g"
TOKA comment = "KAPTON layer", sys = "tpc", module = "tpcegeo1.g"
TONX comment = "Nomex support", sys = "tpc", module = "tpcegeo1.g"
TOST comment = "the Outer Field Cage Support", sys = "tpc", module = "tpcegeo1.g"
TPAD comment = "a real padrow with dimensions defined at positioning time", sys = "tpc", module = "tpcegeo1.g"
TPCE comment = "the TPC envelope", sys = "tpc", module = "tpcegeo1.g"
TPCM comment = "the Central Membrane placed in TPC", sys = "tpc", module = "tpcegeo1.g"
TPCW comment = "the TPC supporting endcap Wheel", sys = "tpc", module = "tpcegeo1.g"
TPEA comment = "one endcap placed in TPC", sys = "tpc", module = "tpcegeo1.g"
TPGV comment = "the Gas Volume placed in TPC", sys = "tpc", module = "tpcegeo1.g"
TPIP comment = "a water pipe there are lots per sect", sys = "tpc", module = "tpcegeo1.g"
TPSS comment = "a division of gas volume corresponding to a supersectors", sys = "tpc", module = "tpcegeo1.g"
TRDC comment = "an RDO Card", sys = "tpc", module = "tpcegeo1.g"
TRDS comment = "a division of rdo board volume corresponding to one supersector", sys = "tpc", module = "tpcegeo1.g"
TRDV comment = "the RDO board volume", sys = "tpc", module = "tpcegeo1.g"
TSEC comment = "a supersector containing Al sector, PCB and MWC volume", sys = "tpc", module = "tpcegeo1.g"
TWGB comment = "added alum blocksin Wheel", sys = "tpc", module = "tpcegeo1.g"
TWGC comment = "the larger Inner air gap in Wheel", sys = "tpc", module = "tpcegeo1.g"
TWGI comment = "the Inner air gap in Wheel", sys = "tpc", module = "tpcegeo1.g"
TWSS comment = "a division of wheel corresponding to supersectors", sys = "tpc", module = "tpcegeo1.g"
upstream", module = "upstgeo.g"
VCNV comment = "converter layer (radiator included)", sys = "vpd", module = "vpddgeo1.g"
VDET comment = "a single detector (Radiator+converter and PMT+electroncs)", sys = "vpd", module = "vpddgeo1.g"
VDTI comment = "inner part of the single detector", sys = "vpd", module = "vpddgeo1.g"
VFEE comment = "the FEE inside the box", sys = "vpd", module = "vpddgeo1.g"
VLEM comment = "a Lemo connector on the FEE boards", sys = "vpd", module = "vpddgeo1.g"
VPBA comment = "the part of the hook that mounts to the front/back plate", sys = "vpd", module = "vpddgeo1.g"
VPBB comment = "the part of the hook that mounts to the base plate", sys = "vpd", module = "vpddgeo1.g"
VPBI comment = "the empty space inside of the FEE box", sys = "vpd", module = "vpddgeo1.g"
VPBO comment = "container for the hook", sys = "vpd", module = "vpddgeo1.g"
VPBP comment = "the Base Plate", sys = "vpd", module = "vpddgeo1.g"
VPBX comment = "the FEE box", sys = "vpd", module = "vpddgeo1.g"
VPCF comment = "the front plate of the boat clamp", sys = "vpd", module = "vpddgeo1.g"
VPCH comment = "the horizontal plate of the boat clamp", sys = "vpd", module = "vpddgeo1.g"
VPCL comment = "the boat clamp", sys = "vpd", module = "vpddgeo1.g"
VPCV comment = "the vertical plate of the boat clamp", sys = "vpd", module = "vpddgeo1.g"
VPDD comment = "the whole VPPD assembly", sys = "vpd", module = "vpddgeo1.g"
VPFA comment = "the central upper part of the frontplate", sys = "vpd", module = "vpddgeo1.g"
VPFB comment = "the middle upper part of the frontplate", sys = "vpd", module = "vpddgeo1.g"
VPFC comment = "the outer upper part of the frontplate", sys = "vpd", module = "vpddgeo:2.g"
VPFP comment = "a single rectangular piece of the frontpanel", sys = "vpd", module = "vpddgeo:2.g"
VPIP comment = "the Long Pipe", sys = "vpd", module = "vpddgeo:2.g"
VPMT comment = "the PMT inner volume", sys = "vpd", module = "vpddgeo:2.g"
VPSA comment = "part of a strut clamp that holds to the frontplate", sys = "vpd", module = "vpddgeo:2.g"
VPSB comment = "part of a strut clamp that holds to the strut", sys = "vpd", module = "vpddgeo:2.g"
VPSC comment = "a clamp that holds the strut", sys = "vpd", module = "vpddgeo:2.g"
VPST comment = "the strut  volume", sys = "vpd", module = "vpddgeo:2.g"
VPSV comment = "the actual strut between front and backplates", sys = "vpd", module = "vpddgeo:2.g"
VPSW comment = "a tiny piece of aluminium that belongs to the strut", sys = "vpd", module = "vpddgeo:2.g"
VRAD comment = "Cerenkov Radiator layer", sys = "vpd", module = "vpddgeo:2.g"
VRNG comment = "a single pVPD Ring or the entire upVPD", sys = "vpd", module = "vpddgeo:2.g"
VSEC comment = "one pVPD sector with all stuff inside", sys = "vpd", module = "vpddgeo:2.g"
VXST comment = "PMT output cables (just to look nicer)", sys = "vpd", module = "vpddgeo:2.g"
YPLA comment = "the active layer of the pixel", sys = "hpdt", module = "hpdtgeo.g"
YPLM comment = "the mother of the pixel ladder", sys = "hpdt", module = "hpdtgeo.g"
YPLP comment = "the mother of the support", sys = "hpdt", module = "hpdtgeo.g"
YPWP comment = "the all silicon layer active and readout ", sys = "hpdt", module = "hpdtgeo.g"
YPWR comment = "the other support", sys = "hpdt", module = "hpdtgeo.g"
YPXM comment = "the mother of the pixel detector volumes  !!define each object", sys = "hpdt", module = "hpdtgeo.g"
ZCAL comment = "the region between the DX and the D0 magnets", sys = "zcal", module =   "zcalgeo.g"}
